11111111111111111111111
1P0T000C100000001111111
10101110111011100000011
1C00100C001000011111111
10111101111101111100011
100000C00000C0000000111
10110111011111011110011
10000100C000010C0001C11
10110101111111011110011
10000100C000010C0000001
10110111011111011110011
10C00001000001T00001011
10111101111101111110011
100010C00010C0000000011
10101110111T11111111111
100000C000000000000E011
11111111111111111111111


